爪	爫
金	釒
丷	八
人	亻
食	饣
㔾	卩
乙	乚
金	钅
皀	皂
屮	山
手	扌
才	扌
夂	夕
毋	母
己	已
火	灬
㚇	𡕩
聿	肀
疒	病
西	覀
草	艹
艸	艹
曰	日
网	罒
千	干
釆	采
老	耂
丂	万
衣	衤
勻	匀
辵	辶
虎	虍
言	讠
小	少
目	罒
攴	攵
別	别
羊	芈
示	礻
戶	户
夲	本
阜	阝
丂	亏
冃	月
肉	月
歹	歺
夂	久
人	入
卓	車
刀	刂
朝	由
埶	执
玉	⺩
邑	阝
牛	牜
丝	纟
已	巳
十	土
犬	犭
曽	曾
兹	茲
冰	冫
乂	又
丝	糸
㐬	巟
二	土
口	囗
水	氵
关	阝
襾	覀
兌	兑
匚	匸
心	忄
